

F 220,100,0

NO       ./path_to_the_north_texture
C            225,230,0
SO        ./path_to_the_south_texture          
EA ./path_to_the_east_texture

WE ./path_to_the_west_texture

11111111111111111111
1111111111111111111
1110111100000N00001
11110111100000000001
10110111100000000001
1011011110000000001
10110111100000000001
10110111100001000001
1111111111111111111