

F 220,100,0

NO       ./path_to_the_north_texture
C            225,230,0
SO        ./path_to_the_south_texture          
EA ./path_to_the_east_texture

WE ./path_to_the_west_texture

111111111111111111
100000100000000001
100001010111111111
100001010100000001
100001010100W00001
100001010100000001
100001000000000001
111111111111111111